██████████
█       ██
█        █
█        █
█        █
█        █
█        █
█        █
█        █
██████████
