█████████████████████████████
█                  █        █
█      ██          █        █
█      ██          █        █
█                           █
█                           █
█              ██           █
█              ██           █
█                           █
█      ██             ███████
█      ██                   █
█                           █
█████████████████████████████