█████████████████████████████
█                  █        █
█      TT          █        █
█      TT          █        █
█                           █
█                           █
█              TT           █
█              TT           █
█                           █
█      TT             ███████
█      TT                   █
█                           █
█████████████████████████████